##########
#........#
#.D....D.#
#........#
#..##.##.#
#........#
#........#
#.D....D.#
#........#
##########
