##################################################
#................................................#
#..####.......D..............####................#
#..#..#..........................#...............#
#..#..#..........####............#...............#
#..#..##########.#..#.##########.#...............#
#..#.............#..#.............#..............#
#..#######.#######..#######.#######..............#
#................................................#
#.............D................................. #
#................................................#
#..#########..............#########..............#
#..#.......#..............#.......#..............#
#..#.......#..............#.......#..............#
#..#.......####......####.#.......#..............#
#..#......................#.......#..............#
#..#########..............#########..............#
#................................................#
#................................................#
#..............D.................................#
#................................................#
##################################################

